%%%%%%%
% %G% %
% % % %
% % % %
%%%P%%% 
%     % 
% %%% %
% % % %
% % % %
% %%% % 
%  .  % 
%%%G%%% 
%%%%%%%