%%%%%%%%%%
%.   P  .%
%%%%%%%%%%