%%%%%%%%%%
%    P   %
%     .  %
% .      %  
%%%%%%%%%%